0 0 0 0 0 0 0 0 0 0 0 0 7 0 0 0 0 0 0
7 7 7 7 7 7 7 7 7 7 7 7 7 7 7 7 7 7 7
7 7 7 7 7 7 7 7 7 7 7 7 7 7 7 7 7 7 7
8 8 8 8 8 8 8 8 8 8 8 8 8 8 8 8 8 8 8
9 9 9 9 9 9 9 9 9 9 9 9 9 9 9 9 9 9 9
1 1 1 1 1 1 1 1 3 0 0 0 0 0 0 0 0 0 0
4 4 4 4 4 4 4 4 5 0 0 0 0 6 1 1 3 8 8
4 4 4 2 4 4 4 4 5 0 0 0 0 4 4 4 5 9 9
4 4 4 2 4 4 4 4 5 0 0 0 0 4 2 4 5 8 8
4 4 4 2 4 4 4 4 5 0 0 0 0 4 4 4 5 9 9