4 1 1 1 1 1 0 0 0 0 0 0 0 0 1 0 0 0 0 0
1 0 0 0 0 1 0 0 0 0 0 0 0 0 0 0 0 0 0 0
1 0 0 0 0 1 0 0 0 0 0 0 0 0 0 0 0 0 0 0
1 0 0 0 0 1 0 0 0 0 0 0 0 0 0 1 0 0 0 0
0 0 0 0 0 1 0 0 0 0 0 0 0 0 0 0 0 0 0 0
1 1 1 1 1 1 1 1 3 0 0 0 0 0 0 0 0 0 0 0
4 4 4 4 4 4 4 4 5 0 0 0 1 0 0 0 0 0 0 0
4 4 4 2 4 4 4 4 5 0 0 0 0 0 0 0 0 0 0 0
4 4 4 2 4 4 4 4 5 0 0 0 0 0 0 0 0 0 0 0
4 4 4 2 4 4 4 4 5 0 0 0 0 0 0 0 0 0 0 0
4 4 4 2 4 4 4 4 5 0 0 0 0 0 0 0 0 0 1 1